OOOOOOOOOOOOOOOOOOOOOOOOOOOOOOOOOOOOOOOOOOOOOOOOOOOOOOOOOOOOOO
OOOOOOOOOOOO   OOOOOOOOOOOOOOOOOOOOOOOOOO ^ to your heart ^ OO
OOOOOOOOOOOO   OOOOOOOOOOOOOOOOOOOOOOOOOOOOOOOOOO   OOOOOOOOOO
OOOOOOOOOOOO   OOOOOOOOOOOOOOOOOOOOOOOOOOOOOOOOOO   OOOOOOOOOO
OOOOOOOOOOOO   OOOOOOOOOOOOOOOOOOOOOOOOOOOOOOOOOO   OOOOOOOOOO
OOOOOOOOOOOO   OOOOOOOOOOOOOOOOOOOOOOOOOOOOOOOOOO   OOOOOOOOOO
OOOOOOOOOOOO X              X OOOOOOOOOOOOOOOOOOO   OOOOOOOOOO
OOOOOOOOOOOOOOOOOOOOOOOOOOO   OOOOOOOOOOOOOOOOOOO   OOOOOOOOOO
OOO                 OOOOOOO   OOO         OOOOOOO   OOOOOOOOOO
OOO                 OOOOOOO   OOO  Item   OOOOOOO   OOOOOOOOOO
OOO                 OOOOOOO   OOO  Store  OOOOOOO   OOOOOOOOOO
OOO       Home      OOOOOOO   OOO         OOOOOOO   OOOOOOOOOO
OOO                 OOOOOOO   OOOOOOOOOOOOOOOOOOO   OOOOOOOOOO
OOO                 OOOOOOO X                         to hell
OOO                 OOOOOOO   OOOOOOOOOOOOOOOOOOOOOOOOOOOOOOOO
OOOOOOOOOOOOOOOOOOOOOOOOOOO   OOOOOOOOOOOOOOOOOOOOOOOOOOOOOOOO
OOOOOOOOOOOOOOOOOOOOOOOOOOO   OOOOOOOOOOOOOOOOOOOOOOOOOOOOOOOO
OOOOOOOOOOOOOOOOOOOOOOOOOOO   OOOOOOOOOOOOOOOOOOOOOOOOOOOOOOOO
OOOOOOOOOOOOOOOOOOOOOOOOOOO   OOOOOOOOOOOOOOOOOOOOOOOOOOOOOOOO
OOOOOOOOOOOOOOOOOOOOOOOOOOO   OOOOOOOOOOOOOOOOOOOOOOOOOOOOOOOO
OOOOOOOOOOOOOOOOOOOOOOO to forest OOOOOOOOOOOOOOOOOOOOOOOOOOOO
OOOOOOOOOOOOOOOOOOOOOOOOOOOOOOOOOOOOOOOOOOOOOOOOOOOOOOOOOOOOOO